NO ./path_to_the_north_texture
SO ./path_to_the_south_texture
WE ./path_to_the_west_texture
EA ./path_to_the_east_texture

F 220,100,0
C 225,30,0

111111111111111111111111111111
100000000000000000000000000001
101111111111111111111111111101
101000000000000000000000000101
101011111111111111111111111101
101010000000000000000000010101
101010111111111111111111010101
101010100000000000000001010101
101010101111111111111101010101
101010101000000000000101010101
101010101011111111110101010101
101010101010000000010101010101
101010101010111111010101010101
101010101010100N10101010101010101
101010101010111111010101010101
101010101010000000010101010101
101010101011111111110101010101
101010101000000000000101010101
101010101111111111111101010101
101010100000000000000001010101
101010111111111111111111010101
101010000000000000000000010101
101011111111111111111111111101
101000000000000000000000000101
101111111111111111111111111101
100000000000000000000000000001
111111111111111111111111111111
