NO textures/blackhexagon.xpm
SO textures/hexagonwall.xpm
WE textures/spaceshipdark.xpm
EA textures/simonkraft/cobblestone_01.xpm

F 80,60,40 
C 80,80,120 

    111111111111111111111
    101000001000000000001
    101010101011111111111
111110100010000010001
100000001111101011101
100000N00000101000001
101111101011101111111
101000001010100000101
101011111010111110101
101010001010100010101
101110101010101010101
100000101010001010001
111111101011111011101
100000101000100010001
101110101110101110111
101000100000100010101
101011111111111010101
100010000000000010001
101010111011111111101
101000001000000000001
111111111111111111111
