11111111111111111111
10000000000000000001
10000000001000000001
10000000000000000001
10000001000000000001
10000000000000001001
10000000000000100001
10000000000000000001
10000000000000000001
11111111111111111111