NO textures/blackhexagon.xpm
SO textures/hexagonwall.xpm
WE textures/spaceshipdark.xpm
EA textures/simonkraft/cobblestone_01.xpm

F 139,69,19
C 135,206,235

11111111111111111111111111111111111111111111
10000000001111000000000000000000000000000001
10111110001000000111111111111111111111100001
10100010001000000100000000000000000001100001
10101010001000000101111111111111111101100001
10001000001000000101000000000000000101100001
11111011111000000101011111111111110101100001
10000000001000000101010000000000010101100001
10111111101000000101010111111111010101100001
10100000101000000101010100000001010101100001
10101110101000000101010101111101010101100001
10101010101000000101010101000101010101100001
10101010101000000101010101010101010101100001
10101010101000000101010101010101010101100001
10000010001000000101010001010001010101100001
11111110111000000101011111110111010101100001
10000000001000000101000000000000010101100001
10111111111000000101111111111111111101100001
10000000001000000100000000000000000001100001
10111111111000000111111111111111111111100001
10000000001000000000000000000000000000000001
10000000001000000000000000000000000000000001
10000N00001111111111111111111111111111111111
11111111111111111111111111111111111111111111
