NO textures/simonkraft/mycelium_top.xpm
SO textures/simonkraft/soul_soil.xpm
WE textures/simonkraft/warped_planks.xpm
EA textures/simonkraft/wet_sponge.xpm

F 101,67,33
C 25,25,25

1111111111111111111111111111111111111111111
1000000000000000000000000000000000000000001
1011111101111111011111110111111101111111101
1010000101000001010000010100000101000001001
1010110101011101010111010101110101011101011
1010100101010001010100010101000101010001001
1010111101010111010101110101011101010111111
1010000001010100010101000101010001010100001
1011111111010101110101011101010111010101101
1000000001010101000101010001010100010101001
1111111101010101111101010111010101110101011
1000000101010101000001010100010101000101001
1011110101010101011111010101110101011101111
1010010101010101010000010101000101010001001
1010010101010101010111110101011101010111101
1010010101010101010100000101010001010100001
1010010101010101010101111101010111010101111
1010000101000101010101000001010100010101001
1011111101110101010101011111010101110101011
1000000000010101010101010000010101000101001
1111111111010101010101010111110101011101011
1000000001010101000101010100000101010001001
1011111101010101111101010101111101010111111
1010000101010101000001010101000001010100001
1010110101010101011111010101011111010101101
1010100101000101010000010101010000010101001
1010111101111101010111110101010111110101011
1010000000000001010100000101010100000101001
1011111111111111010101111101010101111101111
1000000000000000010101000001010101000001001
1111111111111111110101011111010101011111011
1000000000000000000101010000010101010000001
1000000000000000000101010000010101010000001
100000000000000000010101000S010101010000001
1111111111111111111111111111111111111111111