NO textures/simonkraft/respawn_anchor_side0.xpm
SO textures/simonkraft/respawn_anchor_side1.xpm
WE textures/simonkraft/respawn_anchor_side2.xpm
EA textures/simonkraft/respawn_anchor_side3.xpm

F 194,178,128
C 135,206,235

111111111111111111111111111111111111111111111
100000000000000000000000000000000000000000001
101111111111111111111111111111111111111111101
101000000000000000000000000000000000000000101
101011111111111111111111111111111111111110101
101010000000000000000000000000000000000010101
101010111111111111111111111111111111111010101
101010100000000000000000000000000000001010101
101010101111111111111111111111111111101010101
101010101000000000000000000000000000101010101
101010101011111111111111111111111110101010101
101010101010000000000000000000000010101010101
101010101010111111111111111111111010101010101
101010101010100000000000000000001010101010101
101010101010101111111111111111101010101010101
101010101010101000000000000000101010101010101
101010101010101011111111111110101010101010101
101010101010101010000000000010101010101010101
101010101010101010111111111010101010101010101
101010101010101010100000001010101010101010101
101010101010101010101111101010101010101010101
101010101010101010101000101010101010101010101
101010101010101010101010101010101010101010101
101010101010101010101S10101010101010101010101
101010101010101010101111101010101010101010101
101010101010101010100000001010101010101010101
101010101010101010111111111010101010101010101
101010101010101010000000000010101010101010101
101010101010101011111111111110101010101010101
101010101010101000000000000000101010101010101
101010101010101111111111111111101010101010101
101010101010100000000000000000001010101010101
101010101010111111111111111111111010101010101
101010101010000000000000000000000010101010101
101010101011111111111111111111111110101010101
101010101000000000000000000000000000101010101
101010101111111111111111111111111111101010101
101010100000000000000000000000000000001010101
101010111111111111111111111111111111111010101
101010000000000000000000000000000000000010101
101011111111111111111111111111111111111110101
101000000000000000000000000000000000000000101
101111111111111111111111111111111111111111101
100000000000000000000000000000000000000000001
111111111111111111111111111111111111111111111