NO textures/wolfenstein/purple_stone.xpm
SO textures/wolfenstein/red_brick.xpm
WE textures/wolfenstein/mossy.xpm
EA textures/wolfenstein/wood.xpm

F 211,211,211
C 70,130,180

1111111111111111111111111111111111111111
1000000000000000000000000000000000000001
1011111111011111111111111110111111111101
1010000001010000000000000010100000000101
1010111101010111111111111010101111110101
1010100001010100000000001010100000010101
1010101111010101111111101010101111010101
1010101000010101000000101010101000010101
1010101011110101011110101010101011110101
1010101010000101010010101010101010000101
1010101010111101010010101010101010111101
1010101010100001010010101010101010100001
1010101010101111010010101010101010101111
1010101010101000010010101010101010101001
1010101010101011110010101010101010101011
1010101010101010000010101010101010101011
1010101010101010111110101010101010101011
1010101010101010100000101010101010101011
1010101010101010101111101010101010101011
1010101010101010101000001010101010101011
1010101010101010101011111010101010101011
1010101010101010101010000010101010101011
1010101010101010101010111110101010101011
1010101010101010101010100000101010101011
1010000000101010101010101111101010000001
1011111110101010101010101000001011111111
1000000010101010101010101011111010000001
1111111010101010101010101010000010111111
1000001010101010101010101010111110100001
1011101010101010101010101010100000101111
1010001010101010101010101010101111101001
1010111010101010101010101010101000001011
1010100010101010101010101010101011111011
1010101110101010101010101010101010000011
1010101000101010101010101010101010111111
1010101011101010101010101010101010100001
1010101010001010101010101010101010101111
1010101010111010101010101010101010101001
1010101010100010101010101010101010101011
1000101010101110101010101010101010101011
1111101010101000101010101010101010101011
1000001010101011101010101010101010101011
1011111010101010001010101010101010101011
1010000010101010111010101010101010101011
1010111110101010100010101010101010101011
1010100000101010101S10101010101010101011
1010101111101010101110101010101010101011
1010101000001010101000101010101010101011
1010101011111010101011101010101010101011
1010101010000010101010001010101010101011
1010101010111110101010111010101010101011
1000101010100000101010100010101010101001
1111101010101111101010101110101010101111
1000001010101000001010101000101010101001
1111111111111111111111111111111111111111